10
8
0000000000
1101111010
0000001010
0011001110
0001100100
0001000100
0011111100
0000j00000