20
20
0s000011100s00000000
1g111110111g11111010
00000010100000001010
001100r110001100r110
00011001000001100100
00010001111111000100
00111111000011111100
00011001000001000100
00001000000001p11100
00111111000011111100
00111111000011111100
00111111000011111100
00010001111111000100
00111111000011111100
00111111000011111100
00111111000011111100
1g111110111g11111010
00111111000011111100
00111111000011111100
00111111000011111100
